     G
    x x
    x x
    x x
xxxx   xxxxxxxx
x             x
x             x
x             x
x             x
x             x
xxxxxxxx xxxxxx
xpBBBB        x
xpBBBB        x
xppBB         x
xppBB         x
x             x
xxxx xxxxxxxxxx
G p       ppp G
xxxxxxxxxxxxxxx