2 1 0 0 0 0 1 0 0 0 0 1 0 0 0 0 1 
2 1 0 0 2 0 1 0 0 0 0 1 0 0 0 0 1 
2 1 0 0 4 0 1 0 0 0 0 1 0 0 0 0 1 
2 1 0 0 6 0 1 0 0 0 0 1 0 0 0 0 1 
2 1 0 0 8 0 1 0 0 0 0 1 0 0 0 0 1 
3 1 0 0 10 0 1 0 0 0 0 1 0 0 0 0 1 
2 1 0 0 0 0 1 0 0 0 0 1 2 0 0 0 1 
2 1 0 0 2 0 1 0 0 0 0 1 2 0 0 0 1 
2 1 0 0 4 0 1 0 0 0 0 1 2 0 0 0 1 
2 1 0 0 6 0 1 0 0 0 0 1 2 0 0 0 1 
0 1 0 0 8 0 1 0 0 0 0 1 2 0 0 0 1 
2 1 0 0 10 0 1 0 0 0 0 1 2 0 0 0 1 
0 1 0 0 12 0 1 0 0 0 0 1 2 0 0 0 1 
2 1 0 0 0 0 1 0 0 0 0 1 4 0 0 0 1 
2 1 0 0 2 0 1 0 0 0 0 1 4 0 0 0 1 
2 1 0 0 4 0 1 0 0 0 0 1 4 0 0 0 1 
2 1 0 0 6 0 1 0 0 0 0 1 4 0 0 0 1 
0 1 0 0 8 0 1 0 0 0 0 1 4 0 0 0 1 
2 1 0 0 10 0 1 0 0 0 0 1 4 0 0 0 1 
0 1 0 0 12 0 1 0 0 0 0 1 4 0 0 0 1 
2 1 0 0 0 0 1 0 0 0 0 1 6 0 0 0 1 
2 1 0 0 2 0 1 0 0 0 0 1 6 0 0 0 1 
2 1 0 0 4 0 1 0 0 0 0 1 6 0 0 0 1 
2 1 0 0 6 0 1 0 0 0 0 1 6 0 0 0 1 
0 1 0 0 8 0 1 0 0 0 0 1 6 0 0 0 1 
2 1 0 0 10 0 1 0 0 0 0 1 6 0 0 0 1 
0 1 0 0 12 0 1 0 0 0 0 1 6 0 0 0 1 
0 1 0 0 0 0 1 0 0 0 0 1 8 0 0 0 1 
0 1 0 0 2 0 1 0 0 0 0 1 8 0 0 0 1 
0 1 0 0 4 0 1 0 0 0 0 1 8 0 0 0 1 
0 1 0 0 6 0 1 0 0 0 0 1 8 0 0 0 1 
2 1 0 0 8 0 1 0 0 0 0 1 8 0 0 0 1 
2 1 0 0 10 0 1 0 0 0 0 1 8 0 0 0 1 
2 1 0 0 12 0 1 0 0 0 0 1 8 0 0 0 1 
0 1 0 0 14 0 1 0 0 0 0 1 8 0 0 0 1 
0 1 0 0 16 0 1 0 0 0 0 1 8 0 0 0 1 
0 1 0 0 18 0 1 0 0 0 0 1 8 0 0 0 1 
0 1 0 0 20 0 1 0 0 0 0 1 8 0 0 0 1 
0 1 0 0 22 0 1 0 0 0 0 1 8 0 0 0 1 
0 1 0 0 24 0 1 0 0 0 0 1 8 0 0 0 1 
0 1 0 0 26 0 1 0 0 0 0 1 8 0 0 0 1 
0 1 0 0 28 0 1 0 0 0 0 1 8 0 0 0 1 
0 1 0 0 0 0 1 0 0 0 0 1 10 0 0 0 1 
2 1 0 0 2 0 1 0 0 0 0 1 10 0 0 0 1 
2 1 0 0 4 0 1 0 0 0 0 1 10 0 0 0 1 
2 1 0 0 6 0 1 0 0 0 0 1 10 0 0 0 1 
2 1 0 0 8 0 1 0 0 0 0 1 10 0 0 0 1 
2 1 0 0 10 0 1 0 0 0 0 1 10 0 0 0 1 
2 1 0 0 12 0 1 0 0 0 0 1 10 0 0 0 1 
2 1 0 0 14 0 1 0 0 0 0 1 10 0 0 0 1 
2 1 0 0 16 0 1 0 0 0 0 1 10 0 0 0 1 
2 1 0 0 18 0 1 0 0 0 0 1 10 0 0 0 1 
2 1 0 0 20 0 1 0 0 0 0 1 10 0 0 0 1 
2 1 0 0 22 0 1 0 0 0 0 1 10 0 0 0 1 
2 1 0 0 24 0 1 0 0 0 0 1 10 0 0 0 1 
2 1 0 0 26 0 1 0 0 0 0 1 10 0 0 0 1 
0 1 0 0 28 0 1 0 0 0 0 1 10 0 0 0 1 
0 1 0 0 0 0 1 0 0 0 0 1 12 0 0 0 1 
2 1 0 0 2 0 1 0 0 0 0 1 12 0 0 0 1 
2 1 0 0 4 0 1 0 0 0 0 1 12 0 0 0 1 
2 1 0 0 6 0 1 0 0 0 0 1 12 0 0 0 1 
2 1 0 0 8 0 1 0 0 0 0 1 12 0 0 0 1 
2 1 0 0 10 0 1 0 0 0 0 1 12 0 0 0 1 
2 1 0 0 12 0 1 0 0 0 0 1 12 0 0 0 1 
2 1 0 0 14 0 1 0 0 0 0 1 12 0 0 0 1 
2 1 0 0 16 0 1 0 0 0 0 1 12 0 0 0 1 
2 1 0 0 18 0 1 0 0 0 0 1 12 0 0 0 1 
2 1 0 0 20 0 1 0 0 0 0 1 12 0 0 0 1 
2 1 0 0 22 0 1 0 0 0 0 1 12 0 0 0 1 
2 1 0 0 24 0 1 0 0 0 0 1 12 0 0 0 1 
2 1 0 0 26 0 1 0 0 0 0 1 12 0 0 0 1 
0 1 0 0 28 0 1 0 0 0 0 1 12 0 0 0 1 
0 1 0 0 0 0 1 0 0 0 0 1 14 0 0 0 1 
2 1 0 0 2 0 1 0 0 0 0 1 14 0 0 0 1 
2 1 0 0 4 0 1 0 0 0 0 1 14 0 0 0 1 
2 1 0 0 6 0 1 0 0 0 0 1 14 0 0 0 1 
2 1 0 0 8 0 1 0 0 0 0 1 14 0 0 0 1 
2 1 0 0 10 0 1 0 0 0 0 1 14 0 0 0 1 
2 1 0 0 12 0 1 0 0 0 0 1 14 0 0 0 1 
2 1 0 0 14 0 1 0 0 0 0 1 14 0 0 0 1 
2 1 0 0 16 0 1 0 0 0 0 1 14 0 0 0 1 
2 1 0 0 18 0 1 0 0 0 0 1 14 0 0 0 1 
2 1 0 0 20 0 1 0 0 0 0 1 14 0 0 0 1 
2 1 0 0 22 0 1 0 0 0 0 1 14 0 0 0 1 
2 1 0 0 24 0 1 0 0 0 0 1 14 0 0 0 1 
2 1 0 0 26 0 1 0 0 0 0 1 14 0 0 0 1 
0 1 0 0 28 0 1 0 0 0 0 1 14 0 0 0 1 
0 1 0 0 0 0 1 0 0 0 0 1 16 0 0 0 1 
2 1 0 0 2 0 1 0 0 0 0 1 16 0 0 0 1 
2 1 0 0 4 0 1 0 0 0 0 1 16 0 0 0 1 
2 1 0 0 6 0 1 0 0 0 0 1 16 0 0 0 1 
2 1 0 0 8 0 1 0 0 0 0 1 16 0 0 0 1 
2 1 0 0 10 0 1 0 0 0 0 1 16 0 0 0 1 
2 1 0 0 12 0 1 0 0 0 0 1 16 0 0 0 1 
2 1 0 0 14 0 1 0 0 0 0 1 16 0 0 0 1 
2 1 0 0 16 0 1 0 0 0 0 1 16 0 0 0 1 
2 1 0 0 18 0 1 0 0 0 0 1 16 0 0 0 1 
2 1 0 0 20 0 1 0 0 0 0 1 16 0 0 0 1 
2 1 0 0 22 0 1 0 0 0 0 1 16 0 0 0 1 
2 1 0 0 24 0 1 0 0 0 0 1 16 0 0 0 1 
2 1 0 0 26 0 1 0 0 0 0 1 16 0 0 0 1 
0 1 0 0 28 0 1 0 0 0 0 1 16 0 0 0 1 
0 1 0 0 0 0 1 0 0 0 0 1 18 0 0 0 1 
2 1 0 0 2 0 1 0 0 0 0 1 18 0 0 0 1 
2 1 0 0 4 0 1 0 0 0 0 1 18 0 0 0 1 
2 1 0 0 6 0 1 0 0 0 0 1 18 0 0 0 1 
2 1 0 0 8 0 1 0 0 0 0 1 18 0 0 0 1 
2 1 0 0 10 0 1 0 0 0 0 1 18 0 0 0 1 
2 1 0 0 12 0 1 0 0 0 0 1 18 0 0 0 1 
2 1 0 0 14 0 1 0 0 0 0 1 18 0 0 0 1 
2 1 0 0 16 0 1 0 0 0 0 1 18 0 0 0 1 
2 1 0 0 18 0 1 0 0 0 0 1 18 0 0 0 1 
2 1 0 0 20 0 1 0 0 0 0 1 18 0 0 0 1 
2 1 0 0 22 0 1 0 0 0 0 1 18 0 0 0 1 
2 1 0 0 24 0 1 0 0 0 0 1 18 0 0 0 1 
2 1 0 0 26 0 1 0 0 0 0 1 18 0 0 0 1 
0 1 0 0 28 0 1 0 0 0 0 1 18 0 0 0 1 
0 1 0 0 0 0 1 0 0 0 0 1 20 0 0 0 1 
0 1 0 0 2 0 1 0 0 0 0 1 20 0 0 0 1 
0 1 0 0 4 0 1 0 0 0 0 1 20 0 0 0 1 
0 1 0 0 6 0 1 0 0 0 0 1 20 0 0 0 1 
0 1 0 0 8 0 1 0 0 0 0 1 20 0 0 0 1 
0 1 0 0 10 0 1 0 0 0 0 1 20 0 0 0 1 
0 1 0 0 12 0 1 0 0 0 0 1 20 0 0 0 1 
0 1 0 0 14 0 1 0 0 0 0 1 20 0 0 0 1 
2 1 0 0 16 0 1 0 0 0 0 1 20 0 0 0 1 
0 1 0 0 18 0 1 0 0 0 0 1 20 0 0 0 1 
0 1 0 0 20 0 1 0 0 0 0 1 20 0 0 0 1 
0 1 0 0 22 0 1 0 0 0 0 1 20 0 0 0 1 
0 1 0 0 24 0 1 0 0 0 0 1 20 0 0 0 1 
0 1 0 0 26 0 1 0 0 0 0 1 20 0 0 0 1 
0 1 0 0 28 0 1 0 0 0 0 1 20 0 0 0 1 
0 1 0 0 0 0 1 0 0 0 0 1 22 0 0 0 1 
2 1 0 0 2 0 1 0 0 0 0 1 22 0 0 0 1 
2 1 0 0 4 0 1 0 0 0 0 1 22 0 0 0 1 
2 1 0 0 6 0 1 0 0 0 0 1 22 0 0 0 1 
2 1 0 0 8 0 1 0 0 0 0 1 22 0 0 0 1 
2 1 0 0 10 0 1 0 0 0 0 1 22 0 0 0 1 
2 1 0 0 12 0 1 0 0 0 0 1 22 0 0 0 1 
2 1 0 0 14 0 1 0 0 0 0 1 22 0 0 0 1 
2 1 0 0 16 0 1 0 0 0 0 1 22 0 0 0 1 
2 1 0 0 18 0 1 0 0 0 0 1 22 0 0 0 1 
2 1 0 0 20 0 1 0 0 0 0 1 22 0 0 0 1 
2 1 0 0 22 0 1 0 0 0 0 1 22 0 0 0 1 
2 1 0 0 24 0 1 0 0 0 0 1 22 0 0 0 1 
2 1 0 0 26 0 1 0 0 0 0 1 22 0 0 0 1 
0 1 0 0 28 0 1 0 0 0 0 1 22 0 0 0 1 
0 1 0 0 0 0 1 0 0 0 0 1 24 0 0 0 1 
2 1 0 0 2 0 1 0 0 0 0 1 24 0 0 0 1 
2 1 0 0 4 0 1 0 0 0 0 1 24 0 0 0 1 
2 1 0 0 6 0 1 0 0 0 0 1 24 0 0 0 1 
2 1 0 0 8 0 1 0 0 0 0 1 24 0 0 0 1 
2 1 0 0 10 0 1 0 0 0 0 1 24 0 0 0 1 
2 1 0 0 12 0 1 0 0 0 0 1 24 0 0 0 1 
2 1 0 0 14 0 1 0 0 0 0 1 24 0 0 0 1 
2 1 0 0 16 0 1 0 0 0 0 1 24 0 0 0 1 
2 1 0 0 18 0 1 0 0 0 0 1 24 0 0 0 1 
2 1 0 0 20 0 1 0 0 0 0 1 24 0 0 0 1 
2 1 0 0 22 0 1 0 0 0 0 1 24 0 0 0 1 
2 1 0 0 24 0 1 0 0 0 0 1 24 0 0 0 1 
2 1 0 0 26 0 1 0 0 0 0 1 24 0 0 0 1 
0 1 0 0 28 0 1 0 0 0 0 1 24 0 0 0 1 
0 1 0 0 0 0 1 0 0 0 0 1 26 0 0 0 1 
2 1 0 0 2 0 1 0 0 0 0 1 26 0 0 0 1 
2 1 0 0 4 0 1 0 0 0 0 1 26 0 0 0 1 
2 1 0 0 6 0 1 0 0 0 0 1 26 0 0 0 1 
2 1 0 0 8 0 1 0 0 0 0 1 26 0 0 0 1 
2 1 0 0 10 0 1 0 0 0 0 1 26 0 0 0 1 
2 1 0 0 12 0 1 0 0 0 0 1 26 0 0 0 1 
2 1 0 0 14 0 1 0 0 0 0 1 26 0 0 0 1 
2 1 0 0 16 0 1 0 0 0 0 1 26 0 0 0 1 
2 1 0 0 18 0 1 0 0 0 0 1 26 0 0 0 1 
2 1 0 0 20 0 1 0 0 0 0 1 26 0 0 0 1 
2 1 0 0 22 0 1 0 0 0 0 1 26 0 0 0 1 
2 1 0 0 24 0 1 0 0 0 0 1 26 0 0 0 1 
2 1 0 0 26 0 1 0 0 0 0 1 26 0 0 0 1 
0 1 0 0 28 0 1 0 0 0 0 1 26 0 0 0 1 
0 1 0 0 0 0 1 0 0 0 0 1 28 0 0 0 1 
2 1 0 0 2 0 1 0 0 0 0 1 28 0 0 0 1 
2 1 0 0 4 0 1 0 0 0 0 1 28 0 0 0 1 
2 1 0 0 6 0 1 0 0 0 0 1 28 0 0 0 1 
2 1 0 0 8 0 1 0 0 0 0 1 28 0 0 0 1 
2 1 0 0 10 0 1 0 0 0 0 1 28 0 0 0 1 
2 1 0 0 12 0 1 0 0 0 0 1 28 0 0 0 1 
2 1 0 0 14 0 1 0 0 0 0 1 28 0 0 0 1 
2 1 0 0 16 0 1 0 0 0 0 1 28 0 0 0 1 
2 1 0 0 18 0 1 0 0 0 0 1 28 0 0 0 1 
2 1 0 0 20 0 1 0 0 0 0 1 28 0 0 0 1 
2 1 0 0 22 0 1 0 0 0 0 1 28 0 0 0 1 
2 1 0 0 24 0 1 0 0 0 0 1 28 0 0 0 1 
2 1 0 0 26 0 1 0 0 0 0 1 28 0 0 0 1 
0 1 0 0 28 0 1 0 0 0 0 1 28 0 0 0 1 
0 1 0 0 0 0 1 0 0 0 0 1 30 0 0 0 1 
2 1 0 0 2 0 1 0 0 0 0 1 30 0 0 0 1 
2 1 0 0 4 0 1 0 0 0 0 1 30 0 0 0 1 
2 1 0 0 6 0 1 0 0 0 0 1 30 0 0 0 1 
2 1 0 0 8 0 1 0 0 0 0 1 30 0 0 0 1 
2 1 0 0 10 0 1 0 0 0 0 1 30 0 0 0 1 
2 1 0 0 12 0 1 0 0 0 0 1 30 0 0 0 1 
2 1 0 0 14 0 1 0 0 0 0 1 30 0 0 0 1 
2 1 0 0 16 0 1 0 0 0 0 1 30 0 0 0 1 
2 1 0 0 18 0 1 0 0 0 0 1 30 0 0 0 1 
2 1 0 0 20 0 1 0 0 0 0 1 30 0 0 0 1 
2 1 0 0 22 0 1 0 0 0 0 1 30 0 0 0 1 
2 1 0 0 24 0 1 0 0 0 0 1 30 0 0 0 1 
2 1 0 0 26 0 1 0 0 0 0 1 30 0 0 0 1 
0 1 0 0 28 0 1 0 0 0 0 1 30 0 0 0 1 
0 1 0 0 0 0 1 0 0 0 0 1 32 0 0 0 1 
0 1 0 0 2 0 1 0 0 0 0 1 32 0 0 0 1 
0 1 0 0 4 0 1 0 0 0 0 1 32 0 0 0 1 
0 1 0 0 6 0 1 0 0 0 0 1 32 0 0 0 1 
2 1 0 0 8 0 1 0 0 0 0 1 32 0 0 0 1 
0 1 0 0 10 0 1 0 0 0 0 1 32 0 0 0 1 
0 1 0 0 12 0 1 0 0 0 0 1 32 0 0 0 1 
0 1 0 0 14 0 1 0 0 0 0 1 32 0 0 0 1 
0 1 0 0 16 0 1 0 0 0 0 1 32 0 0 0 1 
0 1 0 0 18 0 1 0 0 0 0 1 32 0 0 0 1 
0 1 0 0 20 0 1 0 0 0 0 1 32 0 0 0 1 
0 1 0 0 22 0 1 0 0 0 0 1 32 0 0 0 1 
0 1 0 0 24 0 1 0 0 0 0 1 32 0 0 0 1 
0 1 0 0 26 0 1 0 0 0 0 1 32 0 0 0 1 
0 1 0 0 28 0 1 0 0 0 0 1 32 0 0 0 1 
3 1 0 0 0 0 1 0 0 0 0 1 34 0 0 0 1 
2 1 0 0 2 0 1 0 0 0 0 1 34 0 0 0 1 
2 1 0 0 4 0 1 0 0 0 0 1 34 0 0 0 1 
2 1 0 0 6 0 1 0 0 0 0 1 34 0 0 0 1 
2 1 0 0 8 0 1 0 0 0 0 1 34 0 0 0 1 
2 1 0 0 10 0 1 0 0 0 0 1 34 0 0 0 1 
2 1 0 0 12 0 1 0 0 0 0 1 34 0 0 0 1 
2 1 0 0 14 0 1 0 0 0 0 1 34 0 0 0 1 
2 1 0 0 16 0 1 0 0 0 0 1 34 0 0 0 1 
2 1 0 0 18 0 1 0 0 0 0 1 34 0 0 0 1 
2 1 0 0 20 0 1 0 0 0 0 1 34 0 0 0 1 
2 1 0 0 22 0 1 0 0 0 0 1 34 0 0 0 1 
2 1 0 0 24 0 1 0 0 0 0 1 34 0 0 0 1 
2 1 0 0 26 0 1 0 0 0 0 1 34 0 0 0 1 
3 1 0 0 28 0 1 0 0 0 0 1 34 0 0 0 1 
0 1 0 0 0 0 1 0 0 0 0 1 36 0 0 0 1 
0 1 0 0 2 0 1 0 0 0 0 1 36 0 0 0 1 
0 1 0 0 4 0 1 0 0 0 0 1 36 0 0 0 1 
0 1 0 0 6 0 1 0 0 0 0 1 36 0 0 0 1 
0 1 0 0 8 0 1 0 0 0 0 1 36 0 0 0 1 
0 1 0 0 10 0 1 0 0 0 0 1 36 0 0 0 1 
0 1 0 0 12 0 1 0 0 0 0 1 36 0 0 0 1 
0 1 0 0 14 0 1 0 0 0 0 1 36 0 0 0 1 
0 1 0 0 16 0 1 0 0 0 0 1 36 0 0 0 1 
0 1 0 0 18 0 1 0 0 0 0 1 36 0 0 0 1 
0 1 0 0 20 0 1 0 0 0 0 1 36 0 0 0 1 
0 1 0 0 22 0 1 0 0 0 0 1 36 0 0 0 1 
0 1 0 0 24 0 1 0 0 0 0 1 36 0 0 0 1 
0 1 0 0 26 0 1 0 0 0 0 1 36 0 0 0 1 
0 1 0 0 28 0 1 0 0 0 0 1 36 0 0 0 1 

5 1 0 0 2 0 1 0 0 0 0 1 22 0 0 0 1 
5 1 0 0 2 0 1 0 0 0 0 1 24 0 0 0 1 
5 1 0 0 2 0 1 0 0 0 0 1 26 0 0 0 1 
5 1 0 0 4 0 1 0 0 0 0 1 26 0 0 0 1 
5 1 0 0 2 0 1 0 0 0 0 1 28 0 0 0 1 
5 1 0 0 4 0 1 0 0 0 0 1 28 0 0 0 1 
5 1 0 0 4 0 1 0 0 0 0 1 34 0 0 0 1 
5 1 0 0 20 0 1 0 0 0 0 1 34 0 0 0 1 
5 1 0 0 22 0 1 0 0 0 0 1 34 0 0 0 1 
5 1 0 0 24 0 1 0 0 0 0 1 34 0 0 0 1 

6 1 0 0 13.5791 0 1 0 0 0 0 1 34.1249 0 0 0 1 Hunter

