     G
    x x
    x x
    x x
xxxx   xxxxxxxx
x             x
x             x
x             x
x             x
x             x
xxxxxxxx xxxxxx
x             x
x             x
x             x
x             x
xk            x
xxxx xxxxxxxxxx
G             G
xxxxxxxxxxxxxxx