xxxGxxx
x.....xG
x..p..x.x
x..p..x.x
xxxpxxx.x
x..p....x
x..p....x
x..p....x
xxxpxxxx
x..p..x
G..p..G
x..p..x
xxxpxxx
   G   