xxxGxxx
x.....xG
x.....x.x
x.....x.x
xxx.xxx.x
x.......x
x.......x
x.......x
xxx.xxxx
x.....x
G.....G
x.....x
xxx.xxx
   G   