xxxGxxx
xA....xG
xcp...xkx
xB....x.x
xxx.xxx.x
x.......x
x.......x
xBB.....x
xxx.xxxx
x....xx
G.....G
x.....x
xxxpxxx
   G   