0 1 0 0 0 0 1 0 0 0 0 1 0 0 0 0 1 
0 1 0 0 2 0 1 0 0 0 0 1 0 0 0 0 1 
0 1 0 0 4 0 1 0 0 0 0 1 0 0 0 0 1 
3 1 0 0 6 0 1 0 0 0 0 1 0 0 0 0 1 
0 1 0 0 8 0 1 0 0 0 0 1 0 0 0 0 1 
0 1 0 0 10 0 1 0 0 0 0 1 0 0 0 0 1 
0 1 0 0 12 0 1 0 0 0 0 1 0 0 0 0 1 
0 1 0 0 0 0 1 0 0 0 0 1 2 0 0 0 1 
2 1 0 0 2 0 1 0 0 0 0 1 2 0 0 0 1 
2 1 0 0 4 0 1 0 0 0 0 1 2 0 0 0 1 
2 1 0 0 6 0 1 0 0 0 0 1 2 0 0 0 1 
2 1 0 0 8 0 1 0 0 0 0 1 2 0 0 0 1 
2 1 0 0 10 0 1 0 0 0 0 1 2 0 0 0 1 
0 1 0 0 12 0 1 0 0 0 0 1 2 0 0 0 1 
3 1 0 0 14 0 1 0 0 0 0 1 2 0 0 0 1 
0 1 0 0 0 0 1 0 0 0 0 1 4 0 0 0 1 
2 1 0 0 2 0 1 0 0 0 0 1 4 0 0 0 1 
2 1 0 0 4 0 1 0 0 0 0 1 4 0 0 0 1 
2 1 0 0 6 0 1 0 0 0 0 1 4 0 0 0 1 
2 1 0 0 8 0 1 0 0 0 0 1 4 0 0 0 1 
2 1 0 0 10 0 1 0 0 0 0 1 4 0 0 0 1 
0 1 0 0 12 0 1 0 0 0 0 1 4 0 0 0 1 
2 1 0 0 14 0 1 0 0 0 0 1 4 0 0 0 1 
0 1 0 0 16 0 1 0 0 0 0 1 4 0 0 0 1 
0 1 0 0 0 0 1 0 0 0 0 1 6 0 0 0 1 
2 1 0 0 2 0 1 0 0 0 0 1 6 0 0 0 1 
2 1 0 0 4 0 1 0 0 0 0 1 6 0 0 0 1 
2 1 0 0 6 0 1 0 0 0 0 1 6 0 0 0 1 
2 1 0 0 8 0 1 0 0 0 0 1 6 0 0 0 1 
2 1 0 0 10 0 1 0 0 0 0 1 6 0 0 0 1 
0 1 0 0 12 0 1 0 0 0 0 1 6 0 0 0 1 
2 1 0 0 14 0 1 0 0 0 0 1 6 0 0 0 1 
0 1 0 0 16 0 1 0 0 0 0 1 6 0 0 0 1 
0 1 0 0 0 0 1 0 0 0 0 1 8 0 0 0 1 
0 1 0 0 2 0 1 0 0 0 0 1 8 0 0 0 1 
0 1 0 0 4 0 1 0 0 0 0 1 8 0 0 0 1 
2 1 0 0 6 0 1 0 0 0 0 1 8 0 0 0 1 
0 1 0 0 8 0 1 0 0 0 0 1 8 0 0 0 1 
0 1 0 0 10 0 1 0 0 0 0 1 8 0 0 0 1 
0 1 0 0 12 0 1 0 0 0 0 1 8 0 0 0 1 
2 1 0 0 14 0 1 0 0 0 0 1 8 0 0 0 1 
0 1 0 0 16 0 1 0 0 0 0 1 8 0 0 0 1 
0 1 0 0 0 0 1 0 0 0 0 1 10 0 0 0 1 
2 1 0 0 2 0 1 0 0 0 0 1 10 0 0 0 1 
2 1 0 0 4 0 1 0 0 0 0 1 10 0 0 0 1 
2 1 0 0 6 0 1 0 0 0 0 1 10 0 0 0 1 
2 1 0 0 8 0 1 0 0 0 0 1 10 0 0 0 1 
2 1 0 0 10 0 1 0 0 0 0 1 10 0 0 0 1 
2 1 0 0 12 0 1 0 0 0 0 1 10 0 0 0 1 
2 1 0 0 14 0 1 0 0 0 0 1 10 0 0 0 1 
0 1 0 0 16 0 1 0 0 0 0 1 10 0 0 0 1 
0 1 0 0 0 0 1 0 0 0 0 1 12 0 0 0 1 
2 1 0 0 2 0 1 0 0 0 0 1 12 0 0 0 1 
2 1 0 0 4 0 1 0 0 0 0 1 12 0 0 0 1 
2 1 0 0 6 0 1 0 0 0 0 1 12 0 0 0 1 
2 1 0 0 8 0 1 0 0 0 0 1 12 0 0 0 1 
2 1 0 0 10 0 1 0 0 0 0 1 12 0 0 0 1 
2 1 0 0 12 0 1 0 0 0 0 1 12 0 0 0 1 
2 1 0 0 14 0 1 0 0 0 0 1 12 0 0 0 1 
0 1 0 0 16 0 1 0 0 0 0 1 12 0 0 0 1 
0 1 0 0 0 0 1 0 0 0 0 1 14 0 0 0 1 
2 1 0 0 2 0 1 0 0 0 0 1 14 0 0 0 1 
2 1 0 0 4 0 1 0 0 0 0 1 14 0 0 0 1 
2 1 0 0 6 0 1 0 0 0 0 1 14 0 0 0 1 
2 1 0 0 8 0 1 0 0 0 0 1 14 0 0 0 1 
2 1 0 0 10 0 1 0 0 0 0 1 14 0 0 0 1 
2 1 0 0 12 0 1 0 0 0 0 1 14 0 0 0 1 
2 1 0 0 14 0 1 0 0 0 0 1 14 0 0 0 1 
0 1 0 0 16 0 1 0 0 0 0 1 14 0 0 0 1 
0 1 0 0 0 0 1 0 0 0 0 1 16 0 0 0 1 
0 1 0 0 2 0 1 0 0 0 0 1 16 0 0 0 1 
0 1 0 0 4 0 1 0 0 0 0 1 16 0 0 0 1 
2 1 0 0 6 0 1 0 0 0 0 1 16 0 0 0 1 
0 1 0 0 8 0 1 0 0 0 0 1 16 0 0 0 1 
0 1 0 0 10 0 1 0 0 0 0 1 16 0 0 0 1 
0 1 0 0 12 0 1 0 0 0 0 1 16 0 0 0 1 
0 1 0 0 14 0 1 0 0 0 0 1 16 0 0 0 1 
0 1 0 0 0 0 1 0 0 0 0 1 18 0 0 0 1 
2 1 0 0 2 0 1 0 0 0 0 1 18 0 0 0 1 
2 1 0 0 4 0 1 0 0 0 0 1 18 0 0 0 1 
2 1 0 0 6 0 1 0 0 0 0 1 18 0 0 0 1 
2 1 0 0 8 0 1 0 0 0 0 1 18 0 0 0 1 
0 1 0 0 10 0 1 0 0 0 0 1 18 0 0 0 1 
0 1 0 0 12 0 1 0 0 0 0 1 18 0 0 0 1 
3 1 0 0 0 0 1 0 0 0 0 1 20 0 0 0 1 
2 1 0 0 2 0 1 0 0 0 0 1 20 0 0 0 1 
2 1 0 0 4 0 1 0 0 0 0 1 20 0 0 0 1 
2 1 0 0 6 0 1 0 0 0 0 1 20 0 0 0 1 
2 1 0 0 8 0 1 0 0 0 0 1 20 0 0 0 1 
2 1 0 0 10 0 1 0 0 0 0 1 20 0 0 0 1 
3 1 0 0 12 0 1 0 0 0 0 1 20 0 0 0 1 
0 1 0 0 0 0 1 0 0 0 0 1 22 0 0 0 1 
2 1 0 0 2 0 1 0 0 0 0 1 22 0 0 0 1 
2 1 0 0 4 0 1 0 0 0 0 1 22 0 0 0 1 
2 1 0 0 6 0 1 0 0 0 0 1 22 0 0 0 1 
2 1 0 0 8 0 1 0 0 0 0 1 22 0 0 0 1 
2 1 0 0 10 0 1 0 0 0 0 1 22 0 0 0 1 
0 1 0 0 12 0 1 0 0 0 0 1 22 0 0 0 1 
0 1 0 0 0 0 1 0 0 0 0 1 24 0 0 0 1 
0 1 0 0 2 0 1 0 0 0 0 1 24 0 0 0 1 
0 1 0 0 4 0 1 0 0 0 0 1 24 0 0 0 1 
2 1 0 0 6 0 1 0 0 0 0 1 24 0 0 0 1 
0 1 0 0 8 0 1 0 0 0 0 1 24 0 0 0 1 
0 1 0 0 10 0 1 0 0 0 0 1 24 0 0 0 1 
0 1 0 0 12 0 1 0 0 0 0 1 24 0 0 0 1 
2 1 0 0 0 0 1 0 0 0 0 1 26 0 0 0 1 
2 1 0 0 2 0 1 0 0 0 0 1 26 0 0 0 1 
2 1 0 0 4 0 1 0 0 0 0 1 26 0 0 0 1 
3 1 0 0 6 0 1 0 0 0 0 1 26 0 0 0 1 
2 1 0 0 8 0 1 0 0 0 0 1 26 0 0 0 1 
7 -0.724428 0 -0.689351 7.00077 0 1 0 0 0.689351 0 -0.724428 3.01732 0 0 0 1 

5 1 0 0 4 0 1 0 0 0 0 1 4 0 0 0 1 
5 1 0 0 6 0 1 0 0 0 0 1 24 0 0 0 1 


