3 1 0 0 1 0 1 0 0 0 0 1 -1 0 0 0 1 
2 1 0 0 1 0 1 0 0 0 0 1 1 0 0 0 1 
2 1 0 0 1 0 1 0 0 0 0 1 3 0 0 0 1 
2 1 0 0 1 0 1 0 0 0 0 1 5 0 0 0 1 
2 1 0 0 3 0 1 0 0 0 0 1 5 0 0 0 1 
2 1 0 0 5 0 1 0 0 0 0 1 5 0 0 0 1 
2 1 0 0 7 0 1 0 0 0 0 1 5 0 0 0 1 
2 1 0 0 7 0 1 0 0 0 0 1 3 0 0 0 1 
2 1 0 0 7 0 1 0 0 0 0 1 1 0 0 0 1 
0 1 0 0 5 0 1 0 0 0 0 1 1 0 0 0 1 
0 1 0 0 7 0 1 0 0 0 0 1 -1 0 0 0 1 
0 1 0 0 9 0 1 0 0 0 0 1 1 0 0 0 1 
0 1 0 0 9 0 1 0 0 0 0 1 3 0 0 0 1 
0 1 0 0 9 0 1 0 0 0 0 1 5 0 0 0 1 
0 1 0 0 7 0 1 0 0 0 0 1 7 0 0 0 1 
0 1 0 0 5 0 1 0 0 0 0 1 7 0 0 0 1 
0 1 0 0 3 0 1 0 0 0 0 1 7 0 0 0 1 
0 1 0 0 1 0 1 0 0 0 0 1 7 0 0 0 1 
0 1 0 0 5 0 1 0 0 0 0 1 3 0 0 0 1 
0 1 0 0 3 0 1 0 0 0 0 1 3 0 0 0 1 
0 1 0 0 3 0 1 0 0 0 0 1 1 0 0 0 1 
0 1 0 0 -1 0 1 0 0 0 0 1 7 0 0 0 1 
0 1 0 0 -1 0 1 0 0 0 0 1 3 0 0 0 1 
0 1 0 0 -1 0 1 0 0 0 0 1 1 0 0 0 1 
0 1 0 0 -3 0 1 0 0 0 0 1 9 0 0 0 1 
0 1 0 0 -5 0 1 0 0 0 0 1 9 0 0 0 1 
0 1 0 0 -3 0 1 0 0 0 0 1 -1 0 0 0 1 
0 1 0 0 -5 0 1 0 0 0 0 1 -1 0 0 0 1 
0 1 0 0 -7 0 1 0 0 0 0 1 -1 0 0 0 1 
0 1 0 0 -9 0 1 0 0 0 0 1 1 0 0 0 1 
0 1 0 0 -9 0 1 0 0 0 0 1 3 0 0 0 1 
0 1 0 0 -7 0 1 0 0 0 0 1 9 0 0 0 1 
0 1 0 0 -9 0 1 0 0 0 0 1 9 0 0 0 1 
0 1 0 0 -9 0 1 0 0 0 0 1 7 0 0 0 1 
3 1 0 0 -9 0 1 0 0 0 0 1 5 0 0 0 1 
2 1 0 0 -1 0 1 0 0 0 0 1 5 0 0 0 1 
2 1 0 0 -3 0 1 0 0 0 0 1 5 0 0 0 1 
2 1 0 0 -3 0 1 0 0 0 0 1 7 0 0 0 1 
2 1 0 0 -5 0 1 0 0 0 0 1 7 0 0 0 1 
2 1 0 0 -7 0 1 0 0 0 0 1 7 0 0 0 1 
2 1 0 0 -7 0 1 0 0 0 0 1 5 0 0 0 1 
2 1 0 0 -5 0 1 0 0 0 0 1 5 0 0 0 1 
2 1 0 0 -3 0 1 0 0 0 0 1 3 0 0 0 1 
2 1 0 0 -3 0 1 0 0 0 0 1 1 0 0 0 1 
2 1 0 0 -5 0 1 0 0 0 0 1 3 0 0 0 1 
2 1 0 0 -5 0 1 0 0 0 0 1 1 0 0 0 1 
2 1 0 0 -7 0 1 0 0 0 0 1 3 0 0 0 1 
2 1 0 0 -7 0 1 0 0 0 0 1 1 0 0 0 1 
3 1 0 0 -14 0 1 0 0 0 0 1 5 0 0 0 1 
2 1 0 0 -16 0 1 0 0 0 0 1 5 0 0 0 1 
2 1 0 0 -18 0 1 0 0 0 0 1 5 0 0 0 1 
2 1 0 0 -20 0 1 0 0 0 0 1 5 0 0 0 1 
2 1 0 0 -22 0 1 0 0 0 0 1 5 0 0 0 1 
0 1 0 0 -16 0 1 0 0 0 0 1 7 0 0 0 1 
0 1 0 0 -18 0 1 0 0 0 0 1 7 0 0 0 1 
0 1 0 0 -20 0 1 0 -9.53674e-07 0 0 1 7 0 0 0 1 
0 1 0 0 -22 0 1 0 0 0 0 1 7 0 0 0 1 
0 1 0 0 -22 0 1 0 0 0 0 1 3 0 0 0 1 
0 1 0 0 -20 0 1 0 0 0 0 1 3 0 0 0 1 
0 1 0 0 -18 0 1 0 0 0 0 1 3 0 0 0 1 
0 1 0 0 -16 0 1 0 0 0 0 1 3 0 0 0 1 
3 1 0 0 -24 0 1 0 0 0 0 1 5 0 0 0 1 

5 1 0 0 -17 0 1 0 0 0 0 1 5 0 0 0 1 
5 1 0 0 -18 0 1 0 0 0 0 1 5 0 0 0 1 
5 1 0 0 -19 0 1 0 0 0 0 1 5 0 0 0 1 
5 1 0 0 -20 0 1 0 0 0 0 1 5 0 0 0 1 
5 1 0 0 -21 0 1 0 0 0 0 1 5 0 0 0 1 
5 1 0 0 -2.78214 0 1 0 0 0 0 1 0.639461 0 0 0 1 
5 1 0 0 -2.94288 0 1 0 0 0 0 1 0.94857 0 0 0 1 
5 1 0 0 -3.20253 0 1 0 0 0 0 1 0.491088 0 0 0 1 

6 1 0 0 -22 0 1 0 0 0 0 1 9 0 0 0 1 

