xGxxxxxxxxxxxx
xD.xGg.....xxx
xd.xxxxxx..xxx
x..xx......xxx
x..xx.......xx
x..xx.......xx
xg.xxxxxxx..xx
x..xxxxxxx..xx
x.......xx..xx
x.......xx..xx
x.......xxg.xx
x......xxx..xx
x..xxxxxxx..xx
x............x
x............x
xxxxxxxxxxxxxx
