xxxxxxxxxxxxxxxx
x.....G  G.....x
x.xxxxxxxxxxxx.x
x.x          x.x
x.x          x.x
x.x          xgx
x.x          x.x
x.x          x.x
x.xxxxxxxxxxxx.x
x..gppp.p.g....x
x.xxxxxxxxxxxx.x
x.x          x.x
x.x          x.x
x.x          x.x
x.x          x.x
x.xxxxxxxxxxxx.x
x...p.G  G.p...x
xxxxxxxxxxxxxxxx
