xxxxxxxxxxxxxxxx
x.....G..G.....x
x.xxxxxxxxxxxx.x
x.x          x.x
x.x          x.x
x.x          xgx
x.x          x.x
x.x          x.x
x.xxxxxxxxxxxx.x
x..............x
x.xxxxxxxxxxxx.x
x.x          x.x
x.x          x.x
x.x          x.x
x.x          x.x
x.xxxxxxxxxxxx.x
x.....G..G.....x
xxxxxxxxxxxxxxxx
