xxxxxxxxxxxxxxxxxxx
xpp      x kpp  g x
xpp      x gpp    x
xxxxxxx  xxxxxxx  x
x        xp    x  x
x        x     x  x
x  xxxxp x  xp xp x
x  x  x     x  x  x
x px  xg  p x  x  x
x  x  xxxx  x px  x
x        x  x     x
x  p   p x  x     x
xxxxxxx  xxxxxxxxxx
x     x   p x     x
x    px     x     x
x  xxxxxxx  x  xp x
xp  p  p   p   xp x
xp             xpgx
xGxxxxxxxxxxxxxxxxx