xxxxxx  xxxxxx
x....x  x....x
x....x  x....x
x....G  G....x
x....x  x....x
x...gx  xg...x
xxxxxx  xxxxxx